111111111111
10C000C00001
100000110C01
1000001E0001
10C100110001
1001C000C001
1P00000011C1
111111111111