111111111111111
1C0000C0001C001
1CE000000010001
111111100010001
1000000000000C1
100111111111111
1000C0000000001
111111000011101
1C000000C01PC01
111111111111111