1111111111111111111111111
1P00000000000000000000001
1000011100000000011011001
10C001110000000001CCC1001
10C001110000011111CEC1001
10C000000000000001CCC1001
10C0000000000000011111001
10C0000000000000000000001
10CCC00000000000000000001
10CCC000000001CCCCC000001
10000011100001CCCCC000001
10000011100001CCCCC000001
1000001110000111111000001
1000000000000000000000001
1111111111111111111111111